111111111111111111111111111111111111
1C00C0000000C00000C000000C00000N00C1
101111110111110101111101110111101011
1NC0000000C00000000C1000000C00000001
111101111101110111111101011111011101
10N0C000C1P010000000E0000000C100C001
111111111110101111110111101011111111
10C0000001N0000000C00000001000000C01
101111010101111101101101111010111101
10N0C000C00000C0000000000C00000N0N01
111111111111111111111111111111111111
