11111111111111111
10000C0000C0P0001
1E00000C000000001
11111111111111111