1111111111111111
10E00C0000P00001
1111111111111111