111111111111111111111111111111111
10011100000000C0000000000000P0001
10000000000111000C000000000000001
1000E00000000C000C000000000000001
111111111111111111111111111111111