1111111111111111111
1P00C00000E00000001
10000000C000000N001
10N000C00C000000001
100000C0000000N0001
10N000000C0N0000001
1111111111111111111