1111111111111111111111111111111111111111111111111111111111111111111111111111
1000000000000000000000000000000000000000000000000000000000000000000000000001
1000000000000000000000000000000000000000000000000000000000000000000000000001
1000000000000000000000000000000000000000000000000000000000000000000000000001
1000000000000000000000000000000000000000000000000000000000000000000000000001
1000000000000000000000000000000000000000000000000000000000000000000000000001
10000000000000000000000000000000000N00000000000000000000000000P0000000000001
1000000000000000000000000000000000000000000000000000000000000000000000000001
1000000000000000000000000000000000000000000000000000000000000000000000000001
10000000000000000000000000000000000N0000000000000000000000000000000000000001
10000000000000000000000000000000000N0000000000000000000000000000000000000001
10000000000000000000000000000000000N0000000000000000000000000000000000000001
10000000000000000000000000000000000N0000000000000000000000000000000000000001
10000000000000000000000000000000000N0000000000000000000000000000000000000001
10000000000000000000000000000000000N0000000000000000000000000000000000000001
10000000000000000000000000000000000N0000000000000000000000000000000000000001
10000000000000000000000000000000000N0000000000000000000000000000000000000001
10000000000000000000000000000000000N0000000000000000000000000000000000000001
10000000000000000000000000000000000N0000000000000000000000000000000000000001
10000000000000000000000000000000000N0000000000000000000000000000000000000001
10000000000000000000000000000000000N0000000000000000000000000000000000000001
10000000000000000000000000000000000N0000000000000000000000000000000000000001
10000000000000000000000000000000000N0000000000000000000000000000000000000001
10000000000000000000000000000000000N0000000000000000000000000000000000000001
10000000000000000000000000000000000N0000000000000000000000000000000000000001
1000000000000000000000000000000000000000000000000000000000000000000000000001
1000000000000000000000000000000000000000000000000000000000000000000000000001
1000000000000000000000000000000000000000000000000000000000000000000000000001
1000000000000000000000000000000000000000000000000000000000000000000000000001
1000000000000000000000000000000000000000000000000000000000000000000000000001
1000000000000000000000000000000000000000000000000000000000000000000000000001
10000000000000E00000000000000000000C0000000000000000000000000000000000000001
1000000000000000000000000000000000000000000000000000000000000000000000000001
1111111111111111111111111111111111111111111111111111111111111111111111111111