11111111111111111111111111111111111111111
10000N00000000000000C000000000000000000C1
100000000000N0000000000C0000P000000000001
1000000N000000E0000000000000000000C000001
11111111111111111111111111111111111111111